{
  "startPosition": [4, 2],
  "helptext": "",
  "board": [
    [0, 1, 1, 0, 1, 0, 1, 0, 1],
    [0, 0, 0, 1, 1, 1, 1, 1, 1],
    [0, 1, 0, 1, 1, 1, 0, 0, 0],
    [0, 1, 0, 1, 1, 1, 0, 1, 1],
    [1, 1, 1, 1, 0, 0, 0, 0, 0],
    [0, 1, 1, 0, 0, 0, 1, 1, 1]
  ]
}
